11111111111111111111
1____$______@      1
11111111#1111      1
1       #--------_$1
1       #  11#  1#11
1_____&_#  11#_$&#_1
111#11111  111#11111
1  #          #    1
1__#________&_#    1
1111111111#111#    1
1         #---#    1
1   ___$__#   #_$__1
1   #1111111  1111#1
1___#_______R__$__#1
11111111111111111111
