11111111111111111111
1__$__ ______$_   #1
1#111# #1111111   #1
1#$&_# #       #$_#1
1#111# #       #11#1
1#   # #       #  #1
1#   #-#-----_&#__#1
1#   # #  $ #11111#1
1#_&_#$#1111# ____#1
1111111#      #11#11
1111   #      #  # 1
1$_1___#_-----# _#$1
11111#1111    # 1111
1____#___R____#____1
11111111111111111111
