11111111111111111111
1    $      @      1
11111111#1111      1
1       #-------- $1
1       #  11#  1#11
1       #  11# $ # 1
111#11111  111#11111
1  #          #    1
1  #          #    1
1111111111#111#    1
1         #---#    1
1      $  #   # $  1
1   #1111111  1111#1
1   #       R  $  #1
11111111111111111111
