11111111111111111111
1                  1
1 @                1
1____#             1
1    #             1
1    #             1
1    #             1
1    ___________#__1
1               #  1
1               #  1
1               #  1
1            #_____1
1            #     1
1            #     1
11111111111111111111
