********************
*__________________*
*__________________*
*__________________*
*______#************
*______#___________*
*___@__#___________*
*__***********#____*
*_____________#____*
*_____________******
*__________________*
*__________________*
*__________________*
*__________________*
********************
