11111111111111111111
1                  1
1                  1
1                  1
1                  1
1@                 1
111#1111111111111111
1$ #               1
111#1111111111111111
1$ #               1
111#1111111111111111
1$ #               1
111#1111111111111111
1 R#               1
11111111111111111111
